/////////////////////////
/*///----///-*//*--##---/
/---/-/*///--////--##---/
//--#-//////----/-----///
///-----//*/----//-----//
/-----/----/----//-//---/
///---//////-/////-/--/--
///#--//////--//---/--///
/----------/--//-#-/#-///
/---/------/-------/---*/
/---/---/--/--//--///////
/--///--////--//--///////
//-/*/-#---#---/--------/
//-/-/---#-------#--/////
//-/-/--//////----------/
//-/----////////----//---
/*-///------//-/--/-///--
//-///--#-////----/--//--
//---//----------//------
/----/----*///////-#----/
/----//--////////----/--/
/-##-/------////----///-/
/--#-/------------/////--
//--////////////--/-///--
///---------------------*
