///////////////*/////////
/*///----///--/----#----/
/---/-/*///--////--##---/
//--#-//////----/---#-///
///-----//-/----//-----//
/-----/----/----//------/
///---//////-/////-//-/--
///#--//////--//---/--///
/---------//--//##-/--///
/---/-----//-------/#---/
/---/--/--//--//---/----*
/--///-/////--//--///////
//-/*/---------/---------
//-/-/----------##---////
//-/-/-///////----------/
//-/---/////////----//---
/*-///-----//--/--/-///--
//-///---////-----/--//--
//---//-#--------//------
/----/----*///////------/
/-#--//--////////-#--/--/
/--#-/------////----///-/
/----/------------/////--
//--///////////---/-///--
///----------------------
/////-/////////////#/----
*/------------/////-///-*
---//////////-----------/